ACETAMINOPHEN-BUTALBITAL	ACETAMINOPHEN-BUTALBITAL	III
ACETAMINOPHEN-CODEINE	ACETAMINOPHEN W/CODEINE	III
ACTIQ	FENTANYL CITRATE	II
ADDERALL	AMPHETAMINE SALT COMBO	II
ADDERALL XR	DEXTROAMPHETAMINE-AMPHETA	II
ALA-HIST AC	CODEINE-CONTAINING COUGH PREPARATION	V
ALAHIST DHC	DIHYDROCODEINE CONTAINING COUGH SYRUP	V
ALPRAZOLAM	ALPRAZOLAM	IV
ALPRAZOLAM INTENSOL	ALPRAZOLAM	IV
AMBIEN	ZOLPIDEM TARTRATE	IV
AMBIEN CR	ZOLPIDEM TARTRATE	IV
AMBIFED CD	CODEINE-CONTAINING COUGH PREPARATION	III
AMBIFED CDX	CODEINE-CONTAINING COUGH PREPARATION	III
AMBIFED-G CD	CODEINE-CONTAINING COUGH PREPARATION	III
AMBIFED-G CDX	CODEINE-CONTAINING COUGH PREPARATION	III
AMITRIPTYLINE-CHLORDIAZEP	CHLORDIAZEPOXIDE/AMITRIPTYLINE	IV
AMYTAL SODIUM	AMOBARBITAL	II
ANADROL-50	OXYMETHOLONE	III
ANDRODERM	TESTOSTERONE	III
ANDROGEL	TESTOSTERONE	III
ANDROID	METHYLTESTOSTERONE	III
ANDROSTENEDIONE	ANDROSTENEDIONE	III
ANEXSIA	HYDROCODONE-ACETAMINOPHEN	III
ANOLOR-300	BUTALBITAL-APAP-CAFFEINE	III
APAP-CAFFEINE-DIHYDROCODE	APAP-CAFFEINE-DIHYDROCODE	III
APOMORPHINE HCL	APOMORPHINE HCL	II
ASCOMP WITH CODEINE	ASA-BUTALB-CAFFEINE-CODEI	III
ASPIRIN W/CODEINE	ASPIRIN W/CODEINE	III
ASTRAMORPH-PF	MORPHINE SULFATE	II
ATIVAN	LORAZEPAM	IV
AVINZA	MORPHINE SULFATE	II
B & O SUPPRETTES NO.15-A	BELLADONNA-OPIUM	II
B & O SUPPRETTES NO.16-A	BELLADONNA-OPIUM	II
BALTUSSIN	DIHYDROCODEINE CONTAINING COUGH SYRUP	V
BONTRIL PDM	PHENDIMETRAZINE TARTRATE	III
BONTRIL SLOW-RELEASE	PHENDIMETRAZINE TARTRATE	III
BREVITAL SODIUM	METHOHEXITAL	IV
BRONTEX	CODEINE-CONTAINING COUGH PREPARATION	V
BROVEX CB	CODEINE-CONTAINING COUGH PREPARATION	III
BROVEX CBX	CODEINE-CONTAINING COUGH PREPARATION	III
BROVEX PB C	CODEINE-CONTAINING COUGH PREPARATION	V
BROVEX PB CX	CODEINE-CONTAINING COUGH PREPARATION	V
BUPAP	ACETAMINOPHEN-BUTALBITAL	III
BUPRENEX	BUPRENORPHINE HCL	III
BUPRENORPHINE HCL	BUPRENORPHINE HCL	III
BUTALBITAL-APAP-CAFFEINE	BUTALBITAL-APAP-CAFFEINE	III
BUTISOL SODIUM	BUTIBARBITAL	III
BUTORPHANOL TARTRATE	BUTORPHANOL TARTRATE	IV
BUTRANS	BUPRENORPHINE HCL	III
CAPITAL W-CODEINE	ACETAMINOPHEN W/CODEINE	III
CARISOPRODOL	CARISOPRODOL	IV
CARISOPRODOL COMPOUND-COD	CARISOPRODOL COMPOUND-CODEINE	III
CEBERCLON	CLONAZEPAM	IV
CEPHADYN	ACETAMINOPHEN-BUTALBITAL	III
CESAMET	NABILONE	II
CHERATUSSIN AC	CODEINE-CONTAINING COUGH PREPARATION	V
CHERATUSSIN DAC	CODEINE-CONTAINING COUGH PREPARATION	V
CHLORAL HYDRATE	CHLORAL HYDRATE	IV
CHLORDIAZEPOXIDE HCL	CHLORDIAZEPOXIDE HCL	IV
CLONAZEPAM	CLONAZEPAM	IV
COCAINE HCL	COCAINE HCL	II
COCET	ACETAMINOPHEN W/CODEINE	III
CODAPHEN	ACETAMINOPHEN W/CODEINE	III
CODEINE PHOSPHATE	CODEINE PHOSPHATE	II
CODEINE SULFATE	CODEINE SULFATE	II
CO-GESIC	HYDROCODONE-ACETAMINOPHEN	III
COLDCOUGH PD	DIHYDROCODEINE CONTAINING COUGH SYRUP	V
COMBUNOX	OXYCODONE HCL-IBUPROFEN	II
CONCERTA	METHYLPHENIDATE	II
COTAB A	CODEINE-CONTAINING COUGH PREPARATION	III
COTAB AX	CODEINE-CONTAINING COUGH PREPARATION	III
CURBAN	PHENTERMINE HCL	IV
DAYTRANA	METHYLPHENIDATE	II
DECA-DURABOLIN	NANDROLONE DECANOATE	III
DEHYDROEPIANDROSTERONE	DEHYDROEPIANDROSTERONE	III
DELATESTRYL	TESTOSTERONE ENANTHATE	III
DEMEROL	MEPERIDINE HCL	II
DEPODUR	MORPHINE SULFATE	II
DEPO-TESTOSTERONE	TESTOSTERONE CYPIONATE	III
DESOXYN	METHAMPHETAMINE HCL	II
DESPEC-EXP	DIHYDROCODEINE CONTAINING COUGH SYRUP	V
DESPEC-PDC	DIHYDROCODEINE CONTAINING COUGH SYRUP	V
DEXEDRINE	DEXTROAMPHETAMINE SULFATE	II
DEXTROAMPHETAMINE SULFATE	DEXTROAMPHETAMINE SULFATE	II
DEX-TUSS	CODEINE-CONTAINING COUGH PREPARATION	V
DIASTAT	DIAZEPAM	IV
DIASTAT ACUDIAL	DIAZEPAM	IV
DIAZEPAM	DIAZEPAM	IV
DIDREX	BENZPHETAMINE HCL	III
DIETHYLPROPION HCL	DIETHYLPROPION HCL	IV
DIHISTINE	CODEINE-CONTAINING COUGH PREPARATION	V
DIHISTINE DH	DIHYDROCODEINE CONTAINING COUGH SYRUP	V
DIHYDRO-GP	DIHYDROCODEINE CONTAINING COUGH SYRUP	V
DIHYDRO-PE	DIHYDROCODEINE CONTAINING COUGH SYRUP	V
DIHYDROTESTOSTERONE PROPI	DIHYDROTESTOSTERONE PROPI	III
DILAUDID	HYDROMORPHONE HCL	II
DILAUDID-5	HYDROMORPHONE HCL	II
DILAUDID-HP	HYDROMORPHONE HCL	II
DIPHENOXYLATE-ATROPINE	DIPHENOXYLATE-ATROPINE	V
DIPRIVAN	PROPOFOL	IV
DISKETS	METHADONE HCL	II
DOLOPHINE HCL	METHADONE HCL	II
DOLOREX	BUTORPHANOL	IV
DONNATAL	BELLADONNA-PHENOBARBITAL	IV
DORAL	QUAZEPAM	IV
DUOHIST DH	DIHYDROCODEINE CONTAINING COUGH SYRUP	V
DURAGESIC	FENTANYL	II
DURAMORPH	MORPHINE SULFATE	II
EDLUAR	ZOLPIDEM	IV
EMBEDA	MORPHINE SULFATE / NALTREXONE	II
ENDACOF AC	CODEINE-CONTAINING COUGH PREPARATION	V
ENDACOF-C	CODEINE-CONTAINING COUGH PREPARATION	III
ENDACOF-DC	CODEINE-CONTAINING COUGH PREPARATION	V
ENDAL CD	CODEINE-CONTAINING COUGH PREPARATION	V
ENDOCET	OXYCODONE-ACETAMINOPHEN	II
ENDODAN	OXYCODONE-ASPIRIN	II
EPIDRIN	ISOMETH-D-CHLORALPHENAZ-A	IV
ESGIC	BUTALBITAL-APAP-CAFFEINE	III
ESGIC-PLUS	BUTALBITAL-APAP-CAFFEINE	III
ESTAZOLAM	ESTAZOLAM	IV
ETH-OXYDOSE	OXYCODONE HCL	II
EXALGO	HYDROMORPHONE HCL	II
FARBITAL	BUTALBITAL-ASPIRIN-CAFFEI	III
FASTIN	PHENTERMINE HCL	IV
FENTANYL BASE	FENTANYL BASE	II
FENTANYL CITRATE	FENTANYL CITRATE	II
FENTANYL CITRATE-NS	FENTANYL CITRATE-NS	II 
FENTANYL-BUPIVACAINE-NS	FENTANYL-BUPIVACAINE-NS	II 
FENTANYL-ROPIVACAINE-NS	FENTANYL-ROPIVACAINE-NS	II 
FENTORA	FENTANYL CITRATE	II
FIORICET	BUTALBITAL-APAP-CAFFEINE	III
FIORICET WITH CODEINE	BUTALBITAL-CAFF-APAP-CODE	III
FIORINAL	BUTALBITAL-ASPIRIN-CAFFEI	III
FIORINAL WITH CODEINE #3	ASA-BUTALB-CAFFEINE-CODEI	III
FIRST-TESTOSTERONE	TESTOSTERONE	III
FIRST-TESTOSTERONE MC	TESTOSTERONE	III
FLUOXYMESTERONE	FLUOXYMESTERONE	III
FLURAZEPAM HCL	FLURAZEPAM HCL	IV
FOCALIN	DEXMETHYLPHENIDATE HCL	II
FOCALIN XR	DEXMETHYLPHENIDATE	II
GILTUSS HC	HYDROCODONE CONTAINING COUGH PREPARATION	III
GUAIFENESIN AC	CODEINE-CONTAINING COUGH PREPARATION	V
HALCION	TRIAZOLAM	IV
HYCET	HYDROCODONE-ACETAMINOPHEN	III
HYCODAN	HYDROCODONE CONTAINING COUGH PREPARATION	III
HYDROCODONE-ACETAMINOPHEN	HYDROCODONE-ACETAMINOPHEN	III
HYDROGESIC	HYDROCODONE-ACETAMINOPHEN	III
HYDROMET	HYDROCODONE CONTAINING COUGH PREPARATION	III
HYDROMORPHONE HCL	HYDROMORPHONE HCL	II
HYDROMORPHONE HCL-NS	HYDROMORPHONE HCL-NS	II
HYDROMORPHONE-BUPIVACAINE	HYDROMORPHONE-BUPIVACAINE	II 
HYDRO-TUSSIN DHC	DIHYDROCODEINE CONTAINING COUGH SYRUP	V
HYDROXYAMPHETAMINE HBR	HYDROXYAMPHETAMINE HBR	II
IBUDONE	HYDROCODONE BIT-IBUPROFEN	III
INFUMORPH	MORPHINE SULFATE	II
IONAMIN	PHENTERMINE HCL	IV
J-COF DHC	CODEINE-CONTAINING COUGH PREPARATION	III
J-MAX DHC	CODEINE-CONTAINING COUGH PREPARATION	III
KADIAN	MORPHINE SULFATE	II
KETALAR	KETAMINE	III
KETAMINE HCL-NS	KETAMINE HCL-NS	III
KETAMINE HYDROCHLORIDE	KETAMINE HYDROCHLORIDE	III
KLONOPIN	CLONAZEPAM	IV
LEVORPHANOL TARTRATE	LEVORPHANOL TARTRATE	II
LEXUSS 210	CODEINE-CONTAINING COUGH PREPARATION	III
LIBRAX	CHLORDIAZEPOXIDE-CLIDINIUM	IV
LOMOTIL	DIPHENOXYLATE - ATROPINE	V
LONOX	DIPHENOXYLATE - ATROPINE	V
LORAZEPAM	LORAZEPAM	IV
LORAZEPAM INTENSOL	LORAZEPAM	IV
LORAZEPAM-D5W	LORAZEPAM-D5W	IV
LORAZEPAM-NS	LORAZEPAM-NS	IV
LORCET 10-650	HYDROCODONE-ACETAMINOPHEN	III
LORCET HD	HYDROCODONE-ACETAMINOPHEN	III
LORCET PLUS	HYDROCODONE-ACETAMINOPHEN	III
LORTAB	HYDROCODONE-ACETAMINOPHEN	III
LUMINAL SODIUM	PHENOBARBITAL SODIUM	IV
LUNESTA	ESZOPICLONE	IV
LUSEDRA	FOSPROPOFOL	IV
LYRICA	PREGABALIN	V
MAGNACET	OXYCODONE-ACETAMINOPHEN	II
MAR-COF BP	CODEINE-CONTAINING COUGH PREPARATION	V
MARGESIC	BUTALBITAL-APAP-CAFFEINE	III
MARGESIC H	HYDROCODONE-ACETAMINOPHEN	III
MARINOL	DRONABINOL	III
MAXIDONE	HYDROCODONE-ACETAMINOPHEN	III
MAXIFED CD	CODEINE-CONTAINING COUGH PREPARATION	III
MAXIFED CDX	CODEINE-CONTAINING COUGH PREPARATION	III
MAXIFED-G CD	CODEINE-CONTAINING COUGH PREPARATION	III
MAXIFED-G CDX	CODEINE-CONTAINING COUGH PREPARATION	III
MAXIPHEN CD	CODEINE-CONTAINING COUGH PREPARATION	III
MAXIPHEN CDX	CODEINE-CONTAINING COUGH PREPARATION	III
M-CLEAR	HYDROCODONE CONTAINING COUGH PREPARATION	V
M-CLEAR WC	CODEINE-CONTAINING COUGH PREPARATION	V
MEBARAL	MEPHOBARBITAL	III
M-END PE	CODEINE-CONTAINING COUGH PREPARATION	V
M-END WC	CODEINE-CONTAINING COUGH PREPARATION	V
MEPERIDINE HCL	MEPERIDINE HCL	II
MEPERIDINE HCL-NS	MEPERIDINE HCL-NS	II 
MEPROBAMATE	MEPROBAMATE	IV
MERIDIA	SIBUTRAMINE	IV
METADATE CD	METHYLPHENIDATE	II
METHADONE HCL	METHADONE HCL	II
METHADONE INTENSOL	METHADONE HCL	II
METHADOSE	METHADONE HCL	II
METHITEST	METHYLTESTOSTERONE	III
METHYLIN	METHYLPHENIDATE	II
METHYLIN ER	METHYLPHENIDATE	II
METHYLPHENIDATE ER	METHYLPHENIDATE	II
METHYLPHENIDATE HCL	METHYLPHENIDATE	II
METHYLTESTOSTERONE	METHYLTESTOSTERONE	III
MIDAZOLAM	MIDAZOLAM	V
MIDAZOLAM HCL	MIDAZOLAM HCL	IV
MIDAZOLAM HCL-NS	MIDAZOLAM HCL-NS	IV
MIDRIN	ISOMETH-D-CHLORALPHENAZ-A	IV
MORPHINE SULFATE	MORPHINE SULFATE	II
MORPHINE SULFATE IN DEXTR	MORPHINE SULFATE IN DEXTR	II
MORPHINE SULFATE-D5W	MORPHINE SULFATE-D5W	II 
MORPHINE SULFATE-NS	MORPHINE SULFATE-NS	II 
MOTOFEN	DIFENOXIN - ATROPINE	V
MS CONTIN	MORPHINE SULFATE	II
MYTUSSIN DAC	CODEINE-CONTAINING COUGH PREPARATION	V
NALEX AC	CODEINE-CONTAINING COUGH PREPARATION	V
NANDROLONE DECANOATE	NANDROLONE DECANOATE	III
NEMBUTAL SODIUM	PENTOBARBITAL	II
NEO AC	CODEINE-CONTAINING COUGH PREPARATION	V
NIRAVAM	ALPRAZOLAM	IV
NORCO	HYDROCODONE-ACETAMINOPHEN	III
NOTUSS AC	CODEINE-CONTAINING COUGH PREPARATION	III
NOTUSS DC	CODEINE-CONTAINING COUGH PREPARATION	III
NOTUSS-PE	CODEINE-CONTAINING COUGH PREPARATION	V
NOVADYNE	CODEINE-CONTAINING COUGH PREPARATION	V
NOVADYNE DH	DIHYDROCODEINE CONTAINING COUGH SYRUP	V
NUCYNTA	TAPENTADOL	II
NUMORPHAN	OXYMORPHONE	II
NUVIGIL	ARMODAFINIL	IV
ONSOLIS	FENTANYL	II
OPANA	OXYMORPHONE	II
OPANA ER	OXYMORPHONE	II
OPIUM	OPIUM	II
ORAMORPH SR	MORPHINE SULFATE	II
OXANDRIN	OXANDROLONE	III
OXANDROLONE	OXANDROLONE	III
OXAZEPAM	OXAZEPAM	IV
OXYCODONE HCL	OXYCODONE HCL	II
OXYCODONE HYDROCHLORIDE	OXYCODONE HCL	II
OXYCODONE W/ASPIRIN	OXYCODONE W/ASPIRIN	II 
OXYCODONE-ACETAMINOPHEN	OXYCODONE-ACETAMINOPHEN	II
OXYCODONE-ASPIRIN	OXYCODONE-ASPIRIN	II
OXYCONTIN	OXYCODONE HCL	II
OXYIR	OXYCODONE HCL	II
PANASAL	HYDROCODONE-ASPIRIN	III
PANLOR SS	APAP-CAFFEINE-DIHYDROCODE	III
PARALDEHYDE	PARALDEHYDE	IV
PAREGORIC	PAREGORIC	III
PENTAZOCINE-ACETAMINOPHEN	PENTAZOCINE-ACETAMINOPHEN	III
PENTAZOCINE-NALOXONE HCL	PENTAZOCINE-NALOXONE HCL	IV
PENTOBARBITAL SODIUM	PENTOBARBITAL SODIUM	II
PENTOTHAL	PENTOTHAL	II
PERCOCET	OXYCODONE-ACETAMINOPHEN	II
PERCODAN	OXYCODONE-ASPIRIN	II
PHENERGAN WITH CODEINE	CODEINE-CONTAINING COUGH PREPARATION	V
PHENOBARBITAL	PHENOBARBITAL	IV
PHENOBARBITAL SODIUM	PHENOBARBITAL SODIUM	IV
PHENTERMINE HCL	PHENTERMINE HCL	IV
PHENYLHISTINE	CODEINE-CONTAINING COUGH PREPARATION	V
PHENYLHISTINE DH	DIHYDROCODEINE CONTAINING COUGH SYRUP	V
PLURATUSS	CODEINE-CONTAINING COUGH PREPARATION	V
POLY HIST DHC	CODEINE-CONTAINING COUGH PREPARATION	V
POLY HIST NC	CODEINE-CONTAINING COUGH PREPARATION	V
POLY-TUSSIN AC	CODEINE-CONTAINING COUGH PREPARATION	V
POLY-TUSSIN DHC	DIHYDROCODEINE CONTAINING COUGH SYRUP	V
PRAZOLAMINE	CARISOPRODOL - NUTRITIONAL SUPP	IV
PRIMLEV	OXYCODONE-ACETAMINOPHEN	II
PROCENTRA	DEXTROAMPHETAMINE SULFATE	II
PRO-CLEAR AC	CODEINE-CONTAINING COUGH PREPARATION	V
PRO-CLEAR CAPS	HYDROCODONE CONTAINING COUGH PREPARATION	V
PRO-FAST HS	PHENTERMINE HCL	IV
PRO-FAST SA	PHENTERMINE HCL	IV
PRO-FAST SR	PHENTERMINE HCL	IV
PROMACET	ACETAMINOPHEN-BUTALBITAL	III
PROMETHAZINE VC-CODEINE	CODEINE-CONTAINING COUGH PREPARATION	V
PROPOVEN	PROPOFOL	IV
PRO-RED AC	CODEINE-CONTAINING COUGH PREPARATION	V
PROVIGIL	MODAFINIL	IV
PSEUDOEPHEDRINE-CODEINE	CODEINE-CONTAINING COUGH PREPARATION	III
RELCOF C	CODEINE-CONTAINING COUGH PREPARATION	V
REPREXAIN	HYDROCODONE BIT-IBUPROFEN	III
RESTORIL	TEMAZEPAM	IV
RITALIN	METHYLPHENIDATE	II
RITALIN LA	METHYLPHENIDATE	II
RITALIN-SR	METHYLPHENIDATE	II
ROXICET	OXYCODONE HCL-ACETAMINOPH	II
ROXICODONE	OXYCODONE HCL	II
ROXICODONE INTENSOL	OXYCODONE HCL	II
ROZEREM	RAMELTEON	IV
RYDEX	CODEINE-CONTAINING COUGH PREPARATION	V
SECONAL SODIUM	SECOBARBITAL	II
SEDAPAP	ACETAMINOPHEN-BUTALBITAL	III
SOLFOTON	PHENOBARBITAL	IV
SOMA	CARISOPRODOL	IV
SOMNOTE	CHLORAL HYDRATE	IV
SONATA	ZALEPLON	IV
STADOL	BUTORPHANOL TARTRATE	IV
STAGESIC	HYDROCODONE-ACETAMINOPHEN	III
STANOZOLOL	STANOZOLOL	III
STRAZEPAM	TEMAZEPAM - NUTRITIONAL SUPP	IV
SUBLIMAZE	FENTANYL CITRATE	II
SUBOXONE	BUPRENORPHINE/NALOXONE	III
SUBUTEX	BUPRENORPHINE HCL	III
SUFENTA	SUFENTANIL CITRATE	II
SUFENTANIL CITRATE	SUFENTANIL CITRATE	II
SYNALGOS-DC	APAP-CAFFEINE-DIHYDROCODE	III
TALWIN	PENTAZOCINE	IV
TESTIM	TESTOSTERONE	III
TESTOSTERONE	TESTOSTERONE	III
TESTOSTERONE CYPIONATE	TESTOSTERONE CYPIONATE	III
TESTOSTERONE PROPIONATE	TESTOSTERONE PROPIONATE	III
TESTRED	METHYLTESTOSTERONE	III
THERACODOPHEN-325	HYDROCODONE-ACETAMINOPHEN	III
THERACODOPHEN-650	HYDROCODONE-ACETAMINOPHEN	III
THERACODOPHEN-LOW-90	HYDROCODONE-ACETAMINOPHEN	III
TL-HIST CM	CODEINE-CONTAINING COUGH PREPARATION	III
TRANXENE T-TAB	CLORAZEPATE DIPOTASSIUM	IV
TREZIX	APAP-CAFFEINE-DIHYDROCODE	III
TUSNEL PED-C	CODEINE-CONTAINING COUGH PREPARATION	V
TUSSCOUGH DHC	DIHYDROCODEINE CONTAINING COUGH SYRUP	V
TUSSICAPS	HYDROCODONE CONTAINING COUGH PREPARATION	III
TUSSIGON	HYDROCODONE CONTAINING COUGH PREPARATION	III
TUSSIONEX	HYDROCODONE CONTAINING COUGH PREPARATION	III
TUSSO-C	CODEINE-CONTAINING COUGH PREPARATION	V
TYLENOL-CODEINE NO.3	ACETAMINOPHEN W/CODEINE	III
TYLENOL-CODEINE NO.4	ACETAMINOPHEN W/CODEINE	III
TYLOX	OXYCODONE-ACETAMINOPHEN	II
ULTIVA	REMIFENTANYL	II
VALIUM	DIAZEPAM	IV
VERSED	MIDAZOLAM HCL	IV
VICODIN	HYDROCODONE-ACETAMINOPHEN	III
VICODIN ES	HYDROCODONE-ACETAMINOPHEN	III
VICODIN HP	HYDROCODONE-ACETAMINOPHEN	III
VICOPROFEN	HYDROCODONE BIT-IBUPROFEN	III
VIMPAT	LACOSAMIDE	V
VYVANSE	LISDEXAMFETAMINE	II
XANAX	ALPRAZOLAM	IV
XANAX XR	ALPRAZOLAM	IV
XODOL 10-300	HYDROCODONE-ACETAMINOPHEN	III
XODOL 5-300	HYDROCODONE-ACETAMINOPHEN	III
XODOL 7.5-300	HYDROCODONE-ACETAMINOPHEN	III
XOLOX	OXYCODONE-ACETAMINOPHEN	II
XYREM	SODIUM OXYBATE	III
ZAMICET	HYDROCODONE-ACETAMINOPHEN	III
ZEBUTAL	BUTALBITAL-APAP-CAFFEINE	III
ZERLOR	APAP-CAFFEINE-DIHYDROCODE	III
ZODRYL AC 25	CODEINE-CONTAINING COUGH PREPARATION	III
ZODRYL AC 30	CODEINE-CONTAINING COUGH PREPARATION	III
ZODRYL AC 35	CODEINE-CONTAINING COUGH PREPARATION	III
ZODRYL AC 40	CODEINE-CONTAINING COUGH PREPARATION	III
ZODRYL AC 50	CODEINE-CONTAINING COUGH PREPARATION	III
ZODRYL AC 60	CODEINE-CONTAINING COUGH PREPARATION	III
ZODRYL AC 80	CODEINE-CONTAINING COUGH PREPARATION	III
ZODRYL DAC 25	CODEINE-CONTAINING COUGH PREPARATION	V
ZODRYL DAC 30	CODEINE-CONTAINING COUGH PREPARATION	V
ZODRYL DAC 35	CODEINE-CONTAINING COUGH PREPARATION	V
ZODRYL DAC 40	CODEINE-CONTAINING COUGH PREPARATION	V
ZODRYL DAC 50	CODEINE-CONTAINING COUGH PREPARATION	V
ZODRYL DAC 60	CODEINE-CONTAINING COUGH PREPARATION	V
ZODRYL DAC 80	CODEINE-CONTAINING COUGH PREPARATION	V
ZODRYL DEC 25	CODEINE-CONTAINING COUGH PREPARATION	V
ZODRYL DEC 30	CODEINE-CONTAINING COUGH PREPARATION	V
ZODRYL DEC 35	CODEINE-CONTAINING COUGH PREPARATION	V
ZODRYL DEC 40	CODEINE-CONTAINING COUGH PREPARATION	V
ZODRYL DEC 50	CODEINE-CONTAINING COUGH PREPARATION	V
ZODRYL DEC 60	CODEINE-CONTAINING COUGH PREPARATION	V
ZODRYL DEC 80	CODEINE-CONTAINING COUGH PREPARATION	V
ZOTEX-C	CODEINE-CONTAINING COUGH PREPARATION	V
Z-TUSS AC	CODEINE-CONTAINING COUGH PREPARATION	III
ZYDONE	HYDROCODONE-ACETAMINOPHEN	III